#########################
#@...#.....#.#..........#
#....#..#..#.#.......#..#
#.#..#..#..#.#$.####.####
#.#..#$.#.......#..#....#
#.#..#..#########..####.#
#.####..#.......#.....#.#
#.......#.$####.####$.#.#
#######.#.....#.#..#....#
#.......#.....#.#..####.#
#..#########..#....#....#
#..#.......$.##.#..#$.#.#
#..#..........#.#..#..#.#
#.$####.#######.#..#..#.#
#..#....#.......#$.#..#.#
#..#...$#.......#..#..#.#
#..#....#########..#..#.#
#..####.#..........#..#.#
#.....#.#.##########..#.#
#.$...#.#..$....#...$.#.#
#.....#.#.......#.....#.#
#######.######.######.#.#
#.......#.......#.....#.#
#.!..$..#.....$.......#.#
#########################
