#########################
#@...#.....#.#........?.#
#....#..#..#.#.......#..#
#.#..#..#..#.#$.####.####
#.#..#$.#.....?.#..#....#
#.#..#..#########..####.#
#.####..#.......#.....#.#
#.......#.$####.####$.#.#
#######.#.....#.#..#....#
#.......#.....#.#..####.#
#..#########..#....#....#
#..#.......$.##.#..#$.#.#
#..#..........#.#..#..#.#
#.$####.#######.#..#..#.#
#?.#....#.......#$.#..#.#
#..#...$#.......#..#..#.#
#..#?...#########..#..#.#
#..####.#..........#..#.#
#.....#.#.##########..#.#
#.$...#.#..$....#...$.#.#
#.....#.#.......#.....#.#
#######.######.######.#.#
#.......#.......#.....#.#
#.!..$..#.....$.......#.#
#########################
